---F----
---*----
--***---
--*-****
--*----*
--**-***
---*-S--